{
    "map": [
        "13", "12", "13", "12", "13", "12", "13", "12", "13", "12", "13", "12", "13", "12", "13", "12", "13", "12", "13",
        "11", "00", "14", "00", "14", "00", "14", "00", "14", "00", "14", "00", "14", "00", "14", "00", "14", "00", "11",
        "13", "12", "13", "15", "13", "15", "13", "15", "13", "15", "13", "15", "13", "15", "13", "15", "13", "12", "13",
        "11", "00", "14", "00", "14", "00", "14", "00", "14", "00", "14", "00", "14", "00", "14", "00", "14", "00", "11",
        "13", "12", "13", "15", "13", "15", "13", "15", "13", "15", "13", "15", "13", "15", "13", "15", "13", "12", "13",
        "11", "00", "14", "00", "14", "00", "14", "00", "14", "00", "14", "00", "14", "00", "14", "00", "14", "00", "11",
        "13", "12", "13", "15", "13", "15", "13", "15", "13", "15", "13", "15", "13", "15", "13", "15", "13", "12", "13",
        "11", "00", "14", "00", "14", "00", "14", "00", "14", "00", "14", "00", "14", "00", "14", "00", "14", "00", "11",
        "13", "12", "13", "15", "13", "15", "13", "15", "13", "15", "13", "15", "13", "15", "13", "15", "13", "12", "13",
        "11", "00", "14", "00", "14", "00", "14", "00", "14", "00", "14", "00", "14", "00", "14", "00", "14", "00", "11",
        "13", "12", "13", "15", "13", "15", "13", "15", "13", "15", "13", "15", "13", "15", "13", "15", "13", "12", "13",
        "11", "00", "14", "00", "14", "00", "14", "00", "14", "00", "14", "00", "14", "00", "14", "00", "14", "00", "11",
        "13", "12", "13", "15", "13", "15", "13", "15", "13", "15", "13", "15", "13", "15", "13", "15", "13", "12", "13",
        "11", "00", "14", "00", "14", "00", "14", "00", "14", "00", "14", "00", "14", "00", "14", "00", "14", "00", "11",
        "13", "12", "13", "12", "13", "12", "13", "12", "13", "12", "13", "12", "13", "12", "13", "12", "13", "12", "13"
    ],
    "name": "test2",
    "arrow_count": 3,
    "start": [
        {
            "x": 0,
            "y": 0,
            "angle": 0,
            "type": 0
        },
        {
            "x": 0,
            "y": 4,
            "angle": 0,
            "type": 10
        }
    ]
}|
{
    "map": [
        "13", "12", "13", "12", "13", "12", "13", "12", "13", "12", "13", "12", "13", "12", "13", "12", "13", "12", "13",
        "11", "00", "14", "00", "14", "00", "14", "00", "14", "00", "11", "00", "14", "00", "11", "00", "14", "00", "11",
        "13", "15", "13", "15", "13", "15", "13", "12", "13", "15", "13", "15", "13", "15", "13", "15", "13", "15", "13",
        "11", "00", "14", "00", "14", "00", "11", "00", "14", "00", "14", "00", "14", "00", "11", "00", "14", "00", "11",
        "13", "15", "13", "12", "13", "15", "13", "15", "13", "15", "13", "15", "13", "15", "13", "15", "13", "15", "13",
        "11", "00", "11", "00", "14", "00", "14", "00", "14", "00", "14", "00", "14", "00", "14", "00", "14", "00", "11",
        "13", "15", "13", "15", "13", "12", "13", "15", "13", "12", "13", "15", "13", "15", "13", "15", "13", "15", "13",
        "11", "00", "14", "00", "11", "00", "14", "00", "11", "00", "14", "00", "14", "00", "14", "00", "14", "00", "11",
        "13", "15", "13", "15", "13", "15", "13", "15", "13", "15", "13", "12", "13", "15", "13", "12", "13", "15", "13",
        "11", "00", "11", "00", "14", "00", "14", "00", "14", "00", "14", "00", "11", "00", "11", "00", "14", "00", "11",
        "13", "15", "13", "12", "13", "15", "13", "12", "13", "15", "13", "15", "13", "15", "13", "15", "13", "15", "13",
        "11", "00", "14", "00", "14", "00", "14", "00", "14", "00", "14", "00", "14", "00", "14", "00", "11", "00", "11",
        "13", "15", "13", "15", "13", "15", "13", "15", "13", "15", "13", "15", "13", "12", "13", "15", "13", "15", "13",
        "11", "00", "14", "00", "14", "00", "14", "00", "14", "00", "14", "00", "14", "00", "14", "00", "11", "00", "11",
        "13", "12", "13", "12", "13", "12", "13", "12", "13", "12", "13", "12", "13", "12", "13", "12", "13", "12", "13"
    ],
    "name": "test1",
    "arrow_count": 3,
    "start": [
        {
            "x": 2,
            "y": 6,
            "angle": -90,
            "type": 0
        },
        {
            "x": 5,
            "y": 6,
            "angle": -90,
            "type": 10
        },
        {
            "x": 1,
            "y": 0,
            "angle": 0,
            "type": 10
        },
        {
            "x": 5,
            "y": 3,
            "angle": -90,
            "type": 10
        },
        {
            "x": 8,
            "y": 6,
            "angle": 0,
            "type": 20
        }
    ]
}
